MAP X:38,Y:24
 2 2 2 2 2 2 2 2 2 2 2 2 2 2 2 2 2 2 2 2 2 2 2 2 2 2 2 2 2 2 2 2 2 2 2 2 2 2 
 2 0 0 0 0 0 0 0 0 0 1 1 1 0 0 0 0 0 0 0 0 0 0 0 0 2 2 2 0 0 0 0 0 0 0 0 0 2
 2 0 P 0 0 0 0 0 0 0 0 1 1 0 0 0 0 M 0 0 0 0 0 0 0 0 2 2 0 0 0 0 0 0 0 0 0 2
 2 1 1 1 1 0 0 0 0 0 0 1 0 0 0 0 1 1 1 2 2 0 0 0 0 0 0 2 0 0 0 0 0 0 0 0 0 2
 2 1 1 0 0 0 0 0 0 0 0 1 0 0 1 1 1 1 1 2 2 2 0 0 0 0 0 2 0 0 0 0 0 0 0 0 0 2
 2 2 1 0 0 1 1 1 0 0 0 1 1 0 0 1 2 2 2 2 2 2 2 2 0 0 2 2 0 0 0 0 0 0 0 0 0 2 
 2 2 1 1 0 0 0 1 1 0 0 0 0 1 0 0 0 2 2 2 2 0 0 0 0 0 2 2 0 0 0 0 0 0 0 0 0 2
 2 1 1 1 1 0 0 0 1 1 0 0 0 1 1 0 0 0 M 2 2 2 2 0 0 2 2 2 0 0 0 0 0 0 0 0 0 2
 2 M M 0 0 0 1 1 1 1 1 0 0 0 0 0 1 1 1 0 0 0 0 0 2 2 2 0 0 0 0 0 0 0 0 0 0 2
 2 1 1 1 1 1 1 1 1 1 1 1 1 0 1 1 2 2 0 0 0 0 2 2 2 2 2 0 0 0 0 0 0 0 0 0 0 2
 2 2 0 0 0 0 0 0 0 0 1 1 1 2 2 2 2 0 0 0 0 2 0 0 0 0 0 0 0 0 0 0 0 0 0 0 0 2
 2 1 0 0 0 0 0 0 0 0 0 0 0 0 0 0 0 0 0 0 0 2 2 2 0 0 0 2 0 0 0 0 0 0 0 0 0 2
 2 1 0 0 0 0 0 0 0 0 0 0 0 0 0 0 0 0 0 0 1 0 0 0 0 0 0 2 0 0 0 0 0 0 0 0 0 2
 2 1 0 0 0 0 0 0 0 0 0 0 0 1 1 1 1 1 1 1 1 1 2 2 2 0 0 2 0 0 0 0 0 0 0 0 0 2
 2 1 0 0 0 1 0 M 0 0 1 1 1 1 1 1 1 1 1 1 1 1 2 M M 0 2 2 0 0 0 0 0 0 0 0 0 2
 2 1 0 0 1 1 1 1 1 1 1 1 1 0 0 0 0 0 0 2 0 0 2 2 2 2 2 2 0 0 0 0 0 0 0 0 0 2
 2 1 1 0 0 0 0 0 0 0 1 1 1 0 0 0 0 0 0 0 0 0 0 0 0 0 1 1 1 0 0 0 0 0 0 0 0 2
 2 1 1 1 1 0 0 0 0 0 0 1 1 0 0 0 0 0 0 0 0 0 0 0 0 0 1 1 1 0 0 0 0 0 0 0 2 2
 2 1 1 1 1 1 0 0 0 0 0 0 0 0 0 1 1 0 M 0 1 1 0 0 0 0 1 1 1 1 1 1 1 0 0 0 1 2
 2 1 0 1 1 1 1 0 0 0 0 0 0 1 1 0 0 1 1 1 1 1 1 0 0 0 0 0 0 0 0 0 0 0 1 1 1 2
 2 1 0 0 0 0 0 0 0 0 0 1 1 1 1 1 1 1 1 1 1 1 1 1 0 0 0 0 0 0 0 0 0 1 1 1 1 2
 2 1 M 0 1 0 0 0 1 1 1 1 1 1 1 1 1 1 1 1 1 1 1 1 1 0 0 0 0 0 0 0 1 1 1 1 1 2
 2 1 1 1 1 1 1 1 1 1 1 1 1 1 1 1 1 1 1 1 1 1 1 1 1 1 0 0 0 M 0 1 1 1 1 1 1 2
 2 2 2 2 2 2 2 2 2 2 2 2 2 2 2 2 2 2 2 2 2 2 2 2 2 2 2 2 2 2 2 2 2 2 2 2 2 2