MAP X:38,Y:24
GRAV:78.48,SLOWDOWN:0.000244140625,ACCL:40,JUMP:20,MAX_SPEED:3
 2 2 2 2 2 2 2 2 2 2 2 2 2 2 2 2 2 2 2 2 2 2 2 2 2 2 2 2 2 2 2 2 2 2 2 2 2 2 
 2 0 P 0 0 0 0 0 0 0 1 1 1 0 0 0 0 0 0 0 0 0 0 0 0 2 2 2 0 0 0 0 0 0 0 0 0 2
 2 0 0 0 0 0 0 0 0 0 0 1 1 0 0 0 0 C 0 0 0 0 0 0 0 0 2 2 0 0 0 0 0 0 0 0 0 2
 2 1 1 1 1 0 0 0 0 0 0 1 0 0 0 0 1 1 1 2 2 0 0 0 0 0 0 2 0 0 0 0 0 0 0 0 0 2
 2 1 1 0 0 0 0 0 0 0 0 1 0 0 1 1 1 1 1 2 2 2 0 0 0 0 0 2 0 0 0 0 0 0 0 0 0 2
 2 2 1 0 0 1 1 1 0 0 0 1 1 0 0 1 2 2 2 2 2 2 2 2 0 0 2 2 0 0 0 0 0 0 0 0 0 2 
 2 2 1 1 0 0 0 1 1 0 0 0 0 1 0 0 0 2 2 2 2 0 0 0 0 0 2 2 0 0 0 0 0 0 0 0 0 2
 2 1 1 1 1 0 0 0 1 1 0 0 0 1 1 0 0 0 C 2 2 2 2 0 0 2 2 2 0 0 0 0 0 0 0 0 0 2
 2 C C 0 0 0 1 1 1 1 1 0 0 0 0 0 1 1 1 0 0 0 0 0 2 2 2 0 0 0 0 0 0 0 0 0 0 2
 2 1 1 1 1 1 1 1 1 1 1 1 1 0 1 1 2 2 0 0 0 0 2 2 2 2 2 0 0 0 0 0 0 0 0 0 0 2
 2 2 0 0 0 0 0 0 0 0 1 1 1 2 2 2 2 0 0 0 0 2 0 0 0 0 0 0 0 0 0 0 0 0 0 0 0 2
 2 1 0 0 0 0 0 0 0 0 0 0 0 0 0 0 0 0 0 0 0 2 2 2 0 0 0 2 0 0 0 0 0 0 0 0 0 2
 2 1 0 0 0 0 0 0 0 0 0 0 0 0 0 0 0 0 0 0 1 0 0 0 0 0 0 2 0 0 0 0 0 0 0 0 0 2
 2 1 0 0 0 0 0 0 0 0 0 0 0 1 1 1 1 1 1 1 1 1 2 2 2 0 0 2 0 0 0 0 0 0 0 0 0 2
 2 1 0 0 0 1 0 C 0 0 1 1 1 1 1 1 1 1 1 1 1 1 2 C C 0 2 2 0 0 0 0 0 0 0 0 0 2
 2 1 0 0 1 1 1 1 1 1 1 1 1 0 0 0 0 0 0 2 0 0 2 2 2 2 2 2 0 0 0 0 0 0 0 0 0 2
 2 1 1 0 0 0 0 0 0 0 1 1 1 0 0 0 0 0 0 0 0 0 0 0 0 0 1 1 1 0 0 0 0 0 0 0 0 2
 2 1 1 1 1 0 0 0 0 0 0 1 1 0 0 0 0 0 0 0 0 0 0 0 0 0 1 1 1 0 0 0 0 0 0 0 2 2
 2 1 1 1 1 1 0 0 0 0 0 0 0 0 0 1 1 0 C 0 1 1 0 0 0 0 1 1 1 1 1 1 1 0 0 0 1 2
 2 1 0 1 1 1 1 0 0 0 0 0 0 1 1 0 0 1 1 1 1 1 1 0 0 0 0 0 0 0 0 0 0 0 1 1 1 2
 2 1 0 0 0 0 0 0 0 0 0 1 1 1 1 1 1 1 1 1 1 1 1 1 0 0 0 0 0 0 0 0 0 1 1 1 1 2
 2 1 C 0 1 0 0 0 1 1 1 1 1 1 1 1 1 1 1 1 1 1 1 1 1 0 0 0 0 0 0 0 1 1 1 1 1 2
 2 1 1 1 1 1 1 1 1 1 1 1 1 1 1 1 1 1 1 1 1 1 1 1 1 1 0 0 0 C 0 1 1 1 1 1 1 2
 2 2 2 2 2 2 2 2 2 2 2 2 2 2 2 2 2 2 2 2 2 2 2 2 2 2 2 2 2 2 2 2 2 2 2 2 2 2