MAP X:30,Y:30
GRAV:78.48,SLOWDOWN:0.000244140625,ACCL:40,JUMP:35,MAX_SPEED:3.5
 2 2 2 2 2 2 2 2 2 2 2 2 2 2 2 2 2 2 2 2 2 2 2 2 2 2 2 2 2 2
 2 0 0 0 1 0 0 0 0 0 0 0 0 0 0 0 0 0 1 1 1 1 1 1 1 1 1 1 1 2
 2 P C 0 1 0 2 0 0 0 0 C 0 0 0 0 0 0 0 0 1 1 1 1 1 1 1 1 1 2
 2 1 1 0 1 0 2 0 0 0 0 1 0 0 0 0 0 0 0 0 0 0 1 1 1 1 1 1 1 2
 2 0 0 0 1 0 2 0 0 0 0 0 0 C 0 0 0 0 0 0 0 0 0 0 1 1 1 1 1 2
 2 0 C 0 1 0 2 2 2 2 0 1 1 1 0 0 0 0 0 0 0 0 0 0 0 0 1 1 1 2
 2 0 1 1 1 0 0 0 0 0 0 0 0 0 0 C 0 0 0 0 0 0 0 0 0 0 0 0 1 2
 2 0 0 0 1 0 0 2 2 0 0 1 1 1 1 1 0 0 0 0 0 0 0 0 0 0 0 0 0 2
 2 0 C 0 1 0 2 0 0 2 0 0 0 0 0 0 0 C 0 0 0 0 0 0 0 0 0 0 0 2
 2 1 1 0 1 0 2 0 0 2 0 1 1 1 1 1 1 1 0 0 0 0 0 0 0 0 0 0 0 2
 2 0 0 0 1 0 2 0 0 2 0 0 0 0 0 0 0 0 0 C 0 0 0 0 0 0 0 0 0 2
 2 0 C 0 1 0 0 2 2 0 0 1 1 1 1 1 1 1 1 1 0 0 0 0 0 0 0 0 0 2
 2 0 1 1 1 0 0 0 0 0 0 0 0 0 0 0 0 0 0 0 0 C 0 0 0 0 0 0 0 2
 2 0 0 0 1 0 2 0 0 0 0 1 1 1 1 1 1 1 1 1 1 1 0 0 0 0 0 0 0 2
 2 0 C 0 1 0 2 0 0 0 0 0 0 0 0 0 0 0 0 0 0 0 0 C 0 0 0 0 0 2
 2 1 1 0 1 0 2 0 0 0 0 1 1 1 1 1 1 1 1 1 1 1 1 1 0 0 0 0 0 2
 2 0 0 0 1 0 2 2 2 2 0 0 0 0 0 0 0 0 0 0 0 0 0 0 0 C 0 0 0 2
 2 0 C 0 1 0 0 0 0 0 0 1 1 1 1 1 1 1 1 1 1 1 1 1 1 1 0 0 0 2
 2 0 1 1 1 0 0 0 0 C 0 0 0 0 0 0 0 0 0 0 0 0 0 0 0 0 0 C 0 2
 2 0 1 0 1 0 0 0 0 1 1 1 1 1 1 1 1 1 1 1 1 1 1 1 1 1 1 1 0 2
 2 0 1 0 1 0 0 0 C 0 0 0 0 0 0 0 0 0 0 0 0 0 0 0 0 0 0 0 0 2
 2 0 1 0 1 0 0 0 1 1 0 0 0 0 0 0 0 0 0 0 0 0 0 0 0 0 0 0 0 2
 2 0 1 0 1 0 0 C 0 0 0 0 0 0 0 0 0 0 0 0 0 0 0 0 0 0 0 0 0 2
 2 0 1 0 1 0 0 1 1 1 0 0 0 0 0 0 0 0 0 0 0 0 0 0 0 0 1 1 1 2
 2 0 1 0 1 0 C 0 0 0 0 0 0 0 0 0 0 0 0 0 0 0 1 1 1 1 1 1 1 2
 2 0 1 0 1 0 1 1 1 1 0 0 0 0 0 0 0 0 0 1 1 1 1 1 1 1 1 1 1 2
 2 0 1 0 1 C 0 0 0 0 0 0 0 0 0 0 1 1 1 1 1 1 1 1 1 1 1 1 1 2
 2 0 1 1 1 1 1 1 1 1 0 0 0 0 1 1 1 1 1 1 1 1 1 1 1 1 1 1 1 2
 2 0 0 0 0 0 0 0 0 0 0 0 1 1 1 1 1 1 1 1 1 1 1 1 1 1 1 1 1 2
 2 2 2 2 2 2 2 2 2 2 2 2 2 2 2 2 2 2 2 2 2 2 2 2 2 2 2 2 2 2
 